1111111111111
10C1000000001
1000011111001
1P001110E0001
1111111111111
