11111111111111111111
10000000000000000011
1111P11111100M000001
1000001010101110C001
1C0001000011110111C1
111E0001001100001001
100M0000000000000011
100000C0010101010011
11111111111111111111
